11111111111111111111
1P000000000000000001
10000000000000000001
10000000000000000001
10000000000000000001
10000000000000000001
10000000000000000001
10000000000000000001
1000000X000000000001
10000000000000000001
10000000000000000001
10000000000000000001
10000000000000G00001
10000000000000000001
1000G000000000000001
10000000000000000001
10000000000G000G0001
10000000000000000001
100000000000G0000CE1
11111111111111111111